5 7 8 9 - 1 - - 2
3 1 9 8 - 6 5 7 4
4 6 - 7 - 3 8 9 1
1 8 7 - - - 2 4 3
- - - - - - - - -
9 2 3 - - - 7 5 6
- - - - - - - - -
- - - - - - - - -
- - - - - - - - -
