- 1 6 2 5 8 3 7 9
3 2 7 1 4 9 5 - 8
8 5 9 3 7 - 2 4 1
1 - 4 5 8 7 6 9 2
2 6 5 - 9 1 8 3 7
7 9 8 6 2 3 4 1 -
5 4 1 7 3 2 - 8 6
9 7 2 8 - 4 1 5 3
6 8 - 9 1 5 7 2 4