9 8 1 4 5 3 2 6 7
6 2 3 9 8 7 4 1 5
7 4 5 1 2 6 9 8 3
3 9 7 - - - 8 2 6
1 6 4 - - - 3 5 9
8 5 2 - - - 7 4 1
4 1 6 7 3 8 5 9 2
5 3 9 2 4 1 6 7 8
2 7 8 6 9 5 1 3 4