# - - - - - - - -
- # - - - - - - -
- - # - - - - - -
- - - # - - - - -
- - - - # - - - -
- - - - - # - - -
- - - - - - # - -
- - - - - - - # -
- - - - - - - - #