5 7 8 9 - 1 - - 2
3 1 9 8 - 6 5 7 4
4 6 - 7 - 3 8 9 1
1 8 7 - - - 2 4 3
- - - - - - - - -
9 2 3 - - - 7 5 6
- 9 1 6 - 5 4 3 8
- 4 5 3 - 2 6 - 7
7 3 6 4 - 8 9 2 5